R 900 600
NO textures/cat4.xpm
SO textures/cat2.xpm
WE textures/cat3.xpm
EA textures/cat1.xpm
S textures/sprite_1.xpm
SC textures/sprite_3.xpm
ST textures/sky_1.xpm
FT textures/floor_1.xpm


11111111                  11111111
1000000000000001
1000440004444001
10040     40000004001
1000040004   444001
100004000   0004001
1000444004444001
100000   0000000001
1004444004444001
100000    4000004001
10044440   00004001
10000040000   04001
1004444000004001


10000000000000N1
1111111111111111