R 848 380

NO ./textures/texture4.xpm
SO ./textures/texture1.xpm
WE ./textures/texture2.xpm
EA ./textures/texture3.xpm

S ./textures/pillar.xpm
CO ./textures/bit.xpm
NC ./textures/bomb.xpm
H ./textures/heart.xpm

CT ./textures/sky_1.xpm
FT ./textures/floor_1.xpm

F 184,113,39
C 51,198,227

DS ./textures/died.xpm
WS ./textures/win.xpm


1 1 1 1 1 1 1 1 1 1 1 1 1 1 1 1 1 1 1 1 1 1 1 1 1 1 1 1 1
1 0 0 0 0 0 0 0 0 0 1 1 0 0 0 0 0 0 0 0 0 0 0 0 0 0 0 0 1
1 0 1 1 0 0 0 0 0 1 1 1 0 0 0 0 0 0 C 0 0 0 0 0 1 0 0 0 1
1 0 C 1 0 0 0 X 0 0 0 0 0 0 0 0 0 0 0 0 0 0 0 0 1 0 0 0 1
1 0 1 1 0 0 0 0 0 1 1 1 0 0 0 0 0 0 0 0 0 0 0 0 1 0 0 0 1
1 0 0 0 0 0 0 0 0 0 1 1 0 0 0 0 0 1 1 1 0 1 1 1 1 0 0 0 1
1 1 1 1 0 1 1 1 1 1 1 1 1 1 0 1 1 1 0 0 0 0 0 0 1 0 0 0 1
1 1 1 1 0 1 1 1 1 1 0 0 0 1 0 1 1 1 0 0 L M 1 0 - 0 0 0 1
1 1 0 0 0 0 0 0 1 1 1 0 1 1 0 1 1 1 0 1 0 1 0 0 1 0 0 0 1
1 0 0 C 0 0 0 0 0 0 0 0 0 0 0 0 1 1 0 0 C 0 0 0 1 0 0 0 0
1 0 0 0 0 0 0 0 0 0 X 0 0 0 0 0 1 1 0 1 0 1 0 0 1 0 0 0 1
1 1 0 0 0 0 0 0 1 1 0 1 0 1 0 0 0 0 0 0 0 0 0 0 0 1 1 1 1 0 1
1 1 1 1 0 1 1 1 1 1 C 1 0 1 0 0 0 N 0 0 0 0 0 0 0 0 0 0 0 0 1
1 0 0 0 0 0 0 0 0 0 1 1 0 0 0 0 0 1 0 0 0 0 0 0 0 1 1 1 1 0 1
1 0 0 0 X 0 0 0 0 0 0 0 0 C 0 0 1 0 1 0 0 0 0 1 C 1 0 0 1
1 0 0 0 0 0 0 0 0 0 1 0 0 0 0 1 0 0 0 1 0 1 0 2 0 1 0 0 1
1 0 0 0 0 0 0 0 0 0 1 1 0 1 0 0 0 0 0 0 0 0 0 0 0 0 0 0 1
1 0 C 0 0 0 0 0 0 0 C 1 0 0 0 0 0 0 0 1 0 1 0 0 0 0 0 0 1
1 1 1 1 1 1 1 1 1 1 1 1 1 1 1 1 1 1 1 1 1 1 1 1 1 1 1 1 1