
R 1000 750

F 150    ,     100      ,    214
C 77 ,    197   ,   214
     
NO ./textures/texture1.xpm
SO ./textures/texture2.xpm
WE ./textures/cat3.xpm
EA ./textures/texture4.xpm

S ./textures/pillar.xpm



0000000000000000000000000000000000011111111111
11111111111111111111111111111111111100000000001
1000000000000000000000000000001000000000000200111111111111111111111111111111111
10000000000000000000000000000010000000000000000000000000000000000000000000001
10000000000000000000000000000000000000000000000000000000000000001000000000001
1111111111111111111111111111111111110000000000111111111111111111111111111111111
11111111111111111111111111111111111100000N00001
0000000000000000000000000000000000011111111111









